_ _ _ _ _ _ _ _ _ _
_ _ _ _ 3 3 _ _ _ _
_ _ _ _ 3 3 _ _ _ _
_ _ 2 2 3 3 2 2 _ _
_ 2 1 3 3 3 3 1 2 _
_ 2 3 3 3 3 3 3 2 _
_ 2 3 3 1 1 3 3 2 _
_ 2 1 1 1 1 1 2 2 _
_ _ 2 2 _ _ 2 2 _ _
_ _ _ _ _ _ _ _ _ _